100
20
0  0  0  0  0  0  0  0  0  0  0  0  0  0  0  0  0  0  0  0  0  0  0  0  0  0  0  0  0  0  0  0  0  0  0  0  0  0  0  0  0  0  0  0  0  0  0  0  0  0  0  0  0  0  0  0  0  0  0  0  0  0  0  0  0  0  0  0  0  0  0  0  0  0  0  0  0  0  0  0  0  0  0  0  0  0  24  24  12  24  24  24  24  24  24  24  24  24  24  24 
0  0  0  0  0  0  0  0  0  0  0  0  0  0  0  0  0  0  0  0  0  0  0  0  0  0  0  0  0  0  0  0  0  0  0  0  0  0  0  0  0  0  0  0  0  0  0  0  0  0  0  0  0  0  0  0  0  0  0  0  0  0  0  0  0  0  0  0  0  0  0  0  0  0  0  0  0  0  0  0  0  0  0  0  0  0  24  24  12  24  24  24  24  24  24  24  24  24  24  24 
0  0  0  0  0  0  0  0  0  0  0  0  0  0  0  0  0  0  0  0  0  0  0  0  0  0  0  0  0  0  0  0  0  0  0  0  0  0  0  0  0  0  0  0  0  0  0  0  0  0  0  0  0  0  28  28  0  28  28  0  0  0  0  0  0  0  0  0  0  0  0  0  0  0  0  0  0  0  0  0  0  0  0  0  0  0  24  24  12  24  24  24  24  24  24  24  24  24  24  24 
0  0  0  0  0  0  0  0  0  0  0  0  0  0  0  0  0  0  0  0  0  21  22  22  22  22  22  22  22  22  22  22  22  22  22  22  22  22  22  22  22  22  22  22  22  22  22  22  22  1  3  4  4  4  4  4  4  4  4  4  4  4  4  4  4  4  4  4  4  4  4  4  10  0  0  0  0  0  0  0  0  0  0  0  0  0  24  24  12  24  24  24  24  24  24  24  24  24  24  24 
0  0  0  0  0  0  0  0  0  0  0  0  0  0  0  0  0  0  0  0  21  22  23  0  0  0  0  0  0  0  0  0  0  0  0  0  0  0  0  0  0  0  0  0  0  0  0  0  0  17  11  12  12  12  12  12  12  12  12  12  12  12  0  0  0  0  0  0  0  0  0  12  10  0  0  0  0  0  0  0  0  0  0  0  0  0  24  24  12  24  24  24  24  24  24  24  24  24  24  24
0  0  0  0  0  0  0  0  0  0  0  0  0  0  0  0  0  0  0  0  0  0  0  0  0  0  0  0  0  0  0  0  0  0  0  0  0  0  0  0  0  0  0  0  0  0  0  0  1  3  19  12  12  12  12  12  12  12  12  12  12  12  0  0  0  0  0  0  0  0  0  12  0  0  0  0  0  0  0  0  0  0  0  0  0  0  24  24  24  24  24  24  24  24  24  24  24  24  24  24
0  0  0  0  0  0  0  0  9  3  4  4  4  0  0  4  5  22  0  0  0  0  0  0  0  0  0  0  0  0  0  0  0  0  0  0  0  0  0  0  0  0  0  0  0  0  0  0  17  11  12  12  12  12  12  12  12  12  12  12  12  12  0  0  0  0  0  0  0  0  0  12  0  0  0  0  0  0  0  0  0  0  0  0  0  0  24  24  24  24  24  24  24  24  24  24  24  24  24  24
0  0  0  0  0  0  0  0  9  11  12  12  12  0  0  12  13  0  0  0  0  0  0  0  0  0  0  0  0  0  0  0  0  0  0  0  0  0  0  0  0  0  0  0  0  0  9  3  4  19  12  12  12  0  0  0  0  12  12  12  12  12  0  0  0  0  0  0  0  0  0  12  0  0  0  0  0  0  0  0  0  0  0  0  0  0  24  24  4  24  24  24  24  24  24  24  24  24  24  24
0  0  0  0  0  0  0  0  9  11  12  12  12  0  0  12  13  0  0  0  21  22  22  22  23  0  0  0  0  0  0  0  0  0  0  0  0  0  0  0  0  0  0  0  0  0  9  11  12  12  12  12  12  0  0  0  0  0  12  12  0  12  0  0  0  0  0  0  0  0  0  0  0  0  0  0  0  0  0  0  0  0  0  0  0  0  24  4  4  4  28  28  28  24  24  24  24  24  24  24
0  0  0  0  0  0  0  0  9  11  12  12  12  0  0  12  13  0  0  0  0  0  0  0  0  0  0  0  0  0  0  22  22  22  0  0  0  0  0  0  0  0  0  0  0  0  9  11  12  12  12  12  12  0  0  0  0  0  0  12  0  12  0  0  0  0  0  0  0  0  0  0  0  0  0  0  0  0  0  0  0  0  0  0  0  0  4  4  4  4  4  4  4  4  4  4  4  4 4 4
0  0  0  0  0  0  0  0  9  11  12  12  12  27  27  12  13  0  0  0  0  0  0  0  0  0  0  0  0  0  0  0  0  0  0  0  0  0  0  0  0  0  0  0  0  0  17  11  12  12  12  12  12  0  0  0  0  0  0  0  0  0  0  0  0  0  0  0  0  0  0  0  0  0  4  4  4  4  4  4  4  4  4  4  4  4  4  4  4  4  4  4  4  4  4  4  4  4  4 4
0  0  0  0  0  0  0  0  9  11  12  12  12  26  26  12  13  0  0  0  0  22  22  22  0  0  0  0  0  0  0  0  0  0  0  0  21  22  22  22  22  22  22  22  22  22  23  11  12  12  12  12  12  0  0  0  0  0  0  0  0  0  0  28  28  0  0  0  0  0  0  0  0  0  0  0  0  0  0  0  0  0  12  12  12  12  12  12  12  12  12  12  12  12  12  12  12  12  12  12
0  0  0  0  28  28  0  0  9  11  12  12  12  26  25  12  13  0  28  28  28  0  0  0  0  0  0  0  0  0  0  21  22  23  0  0  0  0  0  0  0  0  0  0  0  0  0  12  12  12  12  12  12  12  12  12  12  12  12  0  4  4  4  4  4  4  4  4  4  4  4  0  0  0  0  0  0  0  0  0  0  0  12  12  12  12  12  12  12  12  12  12  12  12  12  12  12  12  12  12
4  4  4  4  4  4  4  4  4  19  12  12  12  12  12  12  20  4  4  4  4  4  4  4  4  4  4  4  27  27  27  27  27  27  27  27  27  27  27  27  27  27  27  27  27  27  27  27  27  27  27  27  27  27  27  27  27  27  27  27  27  27  27  27  27  27  27  27  27  27  27  27  27  27  27  27  27  27  27  27  27  27  12  12  12  12  12  12  12  12  12  12  12  12  12  12  12  12  12  12
12  12  12  12  12  12  12  12  12  12  12  12  12  12  12  12  12  12  12  12  12  12  12  12  12  12  12  12  25  25  25  25  25  25  26  25  25  26  25  26  25  25  25  25  25  25  25  25  25  25  25  26  25  25  25  25  25  25  25  25  25  26  25  25  25  25  25  26  25  25  26  25  25  26  25  25  26  26  26  26  25  25  12  12  12  12  12  12  12  12  12  12  12  12  12  12  12  12  12  12 
12  12  12  12  12  12  12  12  12  12  12  12  12  12  12  12  12  12  12  12  12  12  12  12  12  12  12  12  25  25  26  25  25  25  25  25  25  25  25  25  25  25  25  25  26  26  25  25  25  25  26  25  25  25  26  25  25  25  25  25  25  26  25  25  26  26  26  25  25  25  25  26  25  25  25  25  25  25  26  25  25  25  12  12  12  12  12  12  12  12  12  12  12  12  12  12  12  12  12  12 
12  12  12  12  12  12  12  12  12  12  12  12  12  12  12  12  12  12  12  12  12  12  12  12  12  12  12  12  25  25  25  26  25  25  25  25  26  25  25  26  26  26  25  25  25  25  25  26  25  26  25  25  25  25  25  25  26  25  25  25  25  26  25  25  25  25  25  25  25  25  25  26  25  25  25  25  25  25  26  25  25  25  12  12  12  12  12  12  12  12  12  12  12  12  12  12  12  12  12  12 
12  12  12  12  12  12  12  12  12  12  12  12  12  12  12  12  12  12  12  12  12  12  12  12  12  12  12  12  26  25  25  26  25  26  25  25  26  26  25  25  25  25  25  25  25  25  25  25  25  26  25  25  25  26  25  25  25  26  25  25  25  25  26  25  25  25  25  25  25  25  26  25  25  25  25  25  26  25  25  25  25  25  12  12  12  12  12  12  12  12  12  12  12  12  12  12  12  12  12  12 
12  12  12  12  12  12  12  12  12  12  12  12  12  12  12  12  12  12  12  12  12  12  12  12  12  12  12  12  25  25  25  25  25  25  25  25  25  25  25  26  26  25  25  25  26  25  25  25  26  25  25  26  25  25  25  25  25  26  25  26  25  25  25  26  26  25  25  25  25  25  25  25  25  25  25  26  26  25  25  25  25  25  12  12  12  12  12  12  12  12  12  12  12  12  12  12  12  12  12  12 
12  12  12  12  12  12  12  12  12  12  12  12  12  12  12  12  12  12  12  12  12  12  12  12  12  12  12  12  26  25  25  26  25  25  25  25  26  25  25  25  25  25  25  25  25  25  25  25  25  25  25  25  25  25  25  25  25  25  25  25  25  25  25  25  26  26  26  25  26  26  26  26  26  26  25  25  25  25  25  25  25  25  12  12  12  12  12  12  12  12  12  12  12  12  12  12  12  12  12  12